18 18 18 18 18 18 18 18 18 18 18 18 18 18 18 18 18 18 18 18 18 18 18 18 18 18 18 18 18 18 18 18 18 18 18 18 18 18 18 18 18 18 18 18 18 18 18 18 18 18 
18 18 18 18 18 18 18 18 18 18 18 18 18 18 18 18 18 18 18 18 18 18 18 18 18 18 18 18 18 18 18 18 18 18 18 18 18 18 18 18 18 18 18 18 18 18 18 18 18 18 
18 18 18 18 18 18 18 18 18 18 18 18 18 18 18 18 18 18 18 18 18 18 18 18 18 18 18 18 18 18 18 18 18 18 18 18 18 18 18 18 18 18 18 18 18 18 18 18 18 18 
18 18 18 18 18 18 18 18 18 18 18 18 18 18 18 18 18 18 18 18 18 18 18 18 18 18 18 19 18 18 18 18 18 18 18 18 18 18 18 18 18 18 18 18 18 18 18 18 18 18 
18 18 18 18 18 18 18 18 18 18 18 18 18 18 18 18 18 18 18 18 18 18 18 18 18 18 18 18 18 18 18 18 18 18 18 18 18 18 18 18 18 18 18 18 18 18 18 18 18 18 
18 18 18 18 18 18 18 18 18 18 18 18 18 19 18 18 18 19 18 18 19 18 18 18 18 18 18 18 18 18 18 18 18 18 18 18 18 18 18 18 18 18 18 18 18 18 18 18 18 18 
18 18 18 18 18 18 18 18 18 18 18 18 18 18 18 18 18 18 18 18 18 18 18 18 18 18 18 18 18 18 18 18 18 18 18 18 18 18 19 18 18 18 18 18 18 18 18 18 18 18 
18 18 18 18 18 18 18 18 18 18 18 18 18 18 18 18 18 18 18 18 18 18 18 18 18 18 18 18 18 18 18 18 18 18 18 18 18 18 18 18 18 18 18 18 18 18 18 18 18 18 
18 18 18 18 18 18 18 18 18 18 18 18 18 18 18 18 18 18 18 18 19 18 18 18 18 18 18 19 18 18 18 18 18 18 19 18 18 18 18 18 18 18 18 18 18 18 18 18 18 18 
18 18 18 18 18 18 18 18 18 19 18 18 18 18 18 18 18 18 18 18 18 18 18 18 18 18 18 18 18 18 18 18 18 18 18 18 18 18 18 18 18 18 18 18 18 18 18 18 18 18 
18 18 18 19 18 18 18 18 18 28 26 26 26 29 18 18 19 18 18 18 18 18 28 26 26 26 26 26 29 18 18 18 18 18 18 18 18 28 26 26 26 29 18 18 18 18 18 18 18 18 
18 18 18 18 18 19 18 18 18 24 16 1 1 23 18 18 19 28 26 26 26 26 27 1 1 1 16 1 23 18 18 18 18 18 18 18 18 24 16 1 16 23 18 18 18 18 18 18 18 18 
18 18 18 18 18 18 18 18 18 24 1 16 16 23 28 26 26 27 16 1 1 1 1 1 1 1 1 1 25 26 26 26 26 26 26 26 29 24 2 1 2 23 18 18 18 18 18 18 18 18 
18 18 18 18 18 18 18 18 18 24 1 1 1 23 24 1 2 1 1 1 1 1 1 16 2 1 1 1 1 1 1 1 1 1 1 16 23 24 1 16 2 23 18 18 18 18 18 18 18 18 
18 19 18 18 18 18 18 18 18 24 20 21 22 23 24 1 1 1 1 1 1 1 1 1 1 1 1 1 1 1 1 1 1 1 2 1 23 30 21 21 21 31 18 18 18 18 18 18 18 18 
18 18 18 18 18 19 18 18 18 24 23 18 30 31 24 1 32 32 32 32 32 8 3 3 3 3 3 3 3 3 3 38 3 7 1 1 25 26 26 26 29 18 18 18 18 18 18 18 18 18 
18 18 18 18 18 18 18 18 18 24 23 28 26 26 27 1 32 1 1 1 32 8 3 17 18 17 18 17 18 17 18 17 3 7 16 1 1 1 1 1 23 18 19 18 18 18 18 18 18 18 
18 18 18 18 18 18 18 18 18 30 31 24 1 1 1 1 32 1 33 1 32 8 3 17 18 17 19 17 18 17 18 17 3 7 1 1 1 1 1 1 23 18 18 18 19 18 18 18 18 18 
18 18 18 18 18 18 18 18 28 26 26 27 1 16 1 1 32 1 1 2 32 8 3 17 18 17 18 17 18 17 19 17 3 7 20 21 21 22 1 16 23 18 18 18 18 18 18 18 18 18 
18 18 18 19 18 18 18 18 24 1 1 1 1 1 1 2 32 32 1 32 32 8 3 17 19 17 18 17 18 17 18 17 3 7 23 18 18 24 1 1 23 18 18 18 18 18 18 18 18 18 
18 18 18 18 18 18 18 18 24 1 16 1 1 2 16 1 1 12 10 13 1 8 3 17 18 17 18 17 18 17 19 17 3 7 23 18 18 30 21 21 31 18 18 18 18 18 18 18 18 18 
18 18 18 18 18 18 18 18 30 21 21 21 22 1 1 1 1 8 38 7 1 8 3 17 18 17 18 17 18 17 18 17 3 7 23 28 26 26 26 26 29 18 19 18 18 18 18 18 18 18 
18 18 18 18 18 18 18 18 18 18 18 18 24 1 1 1 1 8 38 7 1 8 3 17 18 17 18 17 18 17 18 17 3 7 23 24 1 16 1 16 23 18 18 18 18 19 18 18 18 18 
18 18 19 18 18 19 18 18 18 19 18 18 24 1 16 1 1 8 38 7 1 8 3 17 18 17 18 17 18 17 18 17 3 7 23 30 21 21 21 21 31 18 18 18 18 18 18 18 18 18 
18 18 18 18 18 18 18 18 18 18 18 18 24 1 1 1 1 8 38 9 10 11 3 17 18 17 18 17 19 17 18 17 3 7 25 26 26 26 26 26 29 18 18 18 18 18 18 18 18 18 
18 19 18 18 18 18 18 18 18 18 18 18 24 1 1 1 1 8 38 38 38 38 3 3 3 3 3 3 3 3 3 3 3 7 1 1 1 1 1 1 23 18 18 18 18 18 18 18 18 18 
18 18 18 18 18 18 18 18 18 28 26 26 27 1 1 2 1 14 5 5 5 5 5 6 38 4 5 5 5 5 5 5 5 15 1 1 1 1 1 1 23 18 18 19 18 19 18 18 18 18 
18 18 18 18 18 19 18 18 18 24 1 1 1 1 1 20 21 21 21 21 22 1 1 8 38 7 1 1 16 1 1 16 1 1 1 16 1 1 16 1 23 18 18 18 18 18 18 18 18 18 
18 18 18 18 18 18 18 18 18 24 1 1 1 20 21 31 200 200 200 19 30 22 1 8 38 7 1 1 1 1 1 1 1 1 1 1 1 1 1 1 23 18 18 18 18 18 18 18 19 18 
18 18 18 19 18 18 18 18 18 24 1 1 2 23 19 200 200 19 200 200 200 51 1 8 38 7 1 16 1 1 1 1 16 1 1 1 1 1 1 1 23 18 18 19 18 18 18 18 18 18 
18 18 18 18 18 18 18 18 18 24 1 1 1 25 26 26 26 26 26 26 26 27 1 8 38 7 2 2 1 16 1 2 1 1 1 1 16 1 1 16 25 18 18 18 18 18 18 18 18 18 
18 18 18 18 18 18 18 18 18 24 10 10 10 10 10 10 10 10 10 10 10 10 10 11 38 9 10 10 10 10 10 10 10 10 10 10 10 10 10 10 10 32 32 32 32 32 32 32 201 201 
18 18 18 18 18 18 18 18 18 24 3 3 3 3 3 3 3 3 3 3 3 3 3 3 3 3 3 3 3 3 3 3 3 3 3 3 3 3 3 3 3 3 3 3 3 3 3 3 3 3 
18 18 18 18 18 18 18 18 18 24 5 5 5 5 5 5 5 5 5 5 5 5 5 6 38 4 5 5 5 5 5 5 5 5 5 5 5 5 5 5 5 32 32 32 32 32 32 32 201 201 
18 18 18 18 18 18 18 18 18 24 1 1 1 1 1 1 1 1 1 1 1 1 1 8 3 7 38 38 38 38 38 38 38 38 38 3 1 1 1 1 20 18 18 18 18 18 18 19 18 18 
18 18 18 18 18 18 18 18 18 24 1 1 2 16 1 1 16 1 16 1 1 16 1 8 3 7 38 17 17 17 17 17 17 17 17 3 1 1 1 1 23 18 18 18 18 18 18 18 18 18 
18 18 18 18 18 18 18 18 18 24 1 1 1 1 1 1 1 1 1 2 1 1 1 8 3 38 38 17 17 17 17 17 17 17 17 3 1 1 1 1 23 18 18 18 18 18 18 18 18 18 
18 18 18 19 18 18 18 18 18 24 1 1 1 1 1 1 1 1 1 1 1 1 1 14 5 5 38 17 17 17 17 17 17 17 17 3 1 1 1 1 23 18 18 18 18 18 18 18 19 18 
18 18 18 18 19 18 18 18 18 30 21 21 21 21 21 22 1 1 1 1 16 1 20 21 22 1 38 38 38 38 38 38 38 38 38 3 1 20 21 21 31 18 18 18 18 18 18 18 18 18 
18 18 18 18 18 18 18 18 28 26 26 26 26 26 29 24 1 16 1 1 1 1 23 19 24 1 1 1 1 1 1 1 1 1 1 1 1 23 18 18 18 18 18 18 18 18 18 18 18 18 
18 18 18 18 18 18 18 18 24 1 16 1 1 16 23 24 1 1 1 1 20 21 31 18 30 21 21 32 34 34 34 34 34 34 32 21 21 31 18 19 18 18 18 18 18 19 18 18 18 18 
18 18 18 18 18 18 18 18 24 2 1 16 2 1 23 24 1 1 16 1 23 18 18 18 19 18 18 32 34 34 34 34 34 34 32 18 18 18 18 18 18 18 18 18 18 18 18 18 18 18 
18 18 18 18 18 18 18 18 30 21 21 21 21 21 31 30 21 21 21 21 31 18 18 18 18 18 18 32 34 34 34 34 34 34 32 18 18 18 18 18 18 18 18 18 18 18 18 18 18 18 
18 18 18 18 18 18 18 18 19 19 18 18 18 18 18 18 18 18 18 18 18 18 18 18 18 18 18 32 34 34 34 34 34 34 32 18 18 18 18 18 18 18 18 18 18 18 18 18 18 18 
18 18 18 18 18 18 18 18 18 18 18 18 18 18 18 18 18 19 18 18 18 19 18 18 18 18 18 32 34 34 34 34 34 34 32 18 18 18 18 19 18 18 18 18 18 18 18 18 18 18 
18 18 18 18 18 18 18 18 18 18 18 18 18 18 18 18 18 18 18 18 18 18 18 18 18 18 18 32 34 34 34 34 34 34 32 18 18 18 18 18 18 18 18 18 18 18 18 18 18 18 
18 18 18 18 18 18 18 18 18 18 18 18 18 18 18 18 18 18 18 18 18 18 18 18 18 18 18 32 34 34 34 34 34 34 32 18 18 18 18 18 18 18 18 18 18 18 18 18 18 18 
18 18 18 18 18 18 18 18 18 18 18 18 18 18 18 18 18 18 18 18 18 18 18 18 18 18 18 32 34 34 34 34 34 34 32 18 18 18 18 18 18 18 18 18 18 18 18 18 18 18 
18 18 18 18 18 18 18 18 18 18 18 18 18 18 18 18 18 18 18 18 18 18 18 18 18 18 18 32 116 116 116 116 116 116 32 18 18 18 18 18 18 18 18 18 18 18 18 18 18 18 
18 18 18 18 18 18 18 18 18 18 18 18 18 18 18 18 18 18 18 18 18 18 18 18 18 18 18 32 34 34 34 34 34 34 32 18 18 18 18 18 18 18 18 18 18 18 18 18 18 18 
