6 6 6 6 6 6 6 6 6 6 6 6 6 6 6 6 6 6 6 6 6 6 6 6 6 6 6 6 6 6 6 6 6 6 6 6 6 6 6 6 6 6 6 6 6 6 6 6 6 6 
6 6 6 6 6 6 6 6 6 6 6 6 6 6 6 6 6 6 6 6 6 6 6 6 6 6 6 6 6 6 6 6 6 6 6 6 6 6 6 6 6 6 6 6 6 6 6 6 6 6 
6 6 6 6 6 6 6 6 6 6 6 6 6 6 6 6 6 6 6 6 6 6 6 6 6 6 6 6 6 6 6 6 6 6 6 6 6 6 6 6 6 6 6 6 6 6 6 6 6 6 
6 6 6 6 6 6 6 6 6 6 6 6 6 6 6 6 6 6 6 6 6 6 6 6 6 6 6 6 6 6 6 6 6 6 6 6 6 6 6 6 6 6 6 6 6 6 6 6 6 6 
6 6 6 6 6 6 6 6 6 6 6 6 6 6 6 6 6 6 6 6 6 6 6 6 6 6 6 6 6 6 6 6 35 6 6 6 6 6 6 6 6 6 6 6 6 6 6 6 6 6 
6 6 6 6 6 6 6 6 6 6 6 6 6 6 6 6 6 6 6 6 6 6 6 35 6 6 6 6 6 6 6 6 6 6 6 6 6 6 6 6 6 6 6 6 6 6 6 6 6 6 
6 6 6 6 6 6 6 6 6 6 6 6 6 6 6 6 6 6 6 6 6 35 6 6 6 6 6 6 6 6 6 6 6 6 6 6 6 6 6 6 6 6 6 6 6 6 6 6 6 6 
6 6 6 6 6 6 6 6 6 6 6 6 6 6 6 6 6 6 6 6 6 6 6 6 6 6 6 6 6 6 6 6 6 6 6 6 6 6 36 36 36 36 36 36 36 6 6 6 6 6 
6 6 6 6 6 6 6 6 6 6 6 6 6 6 6 6 6 6 6 6 6 6 6 26 27 27 27 27 27 27 27 27 27 28 28 6 6 6 36 6 6 6 6 6 36 6 35 35 6 6 
6 6 6 6 6 6 6 6 6 6 6 6 6 6 35 6 6 6 6 6 6 6 6 29 30 30 30 30 30 30 30 30 30 30 31 6 6 6 36 1 6 7 6 1 36 35 6 6 6 6 
6 6 6 6 6 6 6 6 6 6 6 6 6 6 6 6 6 6 6 6 6 6 6 29 30 30 30 30 30 30 30 30 30 30 31 6 6 6 36 6 6 6 6 6 36 35 5 6 6 6 
6 6 6 6 6 6 6 6 6 6 6 35 6 6 6 35 6 6 6 6 6 6 6 29 30 30 30 30 30 30 30 30 30 30 31 6 6 6 36 36 6 6 6 36 35 6 6 6 6 6 
6 6 6 6 6 6 6 6 6 6 6 35 6 6 6 6 6 6 6 6 6 6 6 32 33 33 33 33 33 33 33 33 33 33 34 6 6 6 6 6 21 19 22 6 35 6 6 6 35 6 
6 6 6 6 6 6 6 6 6 6 6 6 6 6 6 6 6 6 6 6 6 35 6 6 6 6 6 6 6 6 6 6 6 6 6 6 6 6 6 6 17 12 16 6 35 35 6 6 6 6 
6 6 6 6 6 6 6 6 6 6 6 6 6 6 6 35 6 6 6 6 6 6 6 39 40 40 40 40 40 40 41 6 21 19 19 19 19 19 19 19 20 12 16 6 6 35 6 6 6 6 
6 6 6 6 6 6 6 6 6 6 6 6 6 6 6 6 35 6 6 6 6 6 6 42 38 38 38 38 38 38 43 6 17 12 12 12 12 12 12 12 12 12 16 6 6 6 35 6 6 6 
6 6 6 6 6 6 6 35 6 6 6 35 6 6 6 6 6 6 6 6 6 6 6 42 38 38 38 38 38 38 43 6 23 14 14 14 14 14 14 14 14 14 24 6 6 6 6 35 35 6 
6 6 6 6 6 6 6 6 6 6 6 6 6 6 6 6 6 6 6 6 6 6 6 42 38 38 38 38 38 38 49 40 40 40 41 6 6 6 6 6 6 6 6 6 35 6 6 6 35 6 
6 6 6 6 6 6 6 6 6 6 6 6 6 6 6 6 35 6 6 6 35 6 6 42 38 38 38 38 38 38 38 38 38 38 43 6 6 6 35 6 6 6 6 6 6 6 6 35 6 6 
6 6 6 6 6 6 6 6 6 6 6 6 6 6 6 6 6 6 6 6 6 6 6 42 38 38 38 38 38 38 38 38 38 38 43 6 6 6 6 6 6 6 6 6 6 6 35 35 6 6 
6 6 6 6 6 6 6 35 6 6 35 6 6 6 6 6 6 6 6 6 35 6 6 44 45 45 45 45 45 45 45 45 45 45 46 6 6 6 6 6 35 6 6 6 6 35 6 6 6 6 
6 6 6 6 6 6 6 6 6 6 6 6 6 6 6 6 35 6 6 6 6 6 6 6 6 6 6 6 6 6 6 6 6 6 6 6 6 6 6 6 6 6 6 6 6 6 6 6 6 6 
6 6 6 6 6 6 6 6 6 6 35 6 35 6 6 6 6 6 6 6 6 6 6 6 6 6 6 6 6 6 6 6 6 6 35 6 6 6 6 35 6 6 6 6 6 6 6 6 35 6 
6 6 6 6 6 6 6 6 6 6 6 6 6 6 6 6 6 6 6 6 6 6 6 35 6 6 6 6 6 35 6 6 6 6 6 6 6 6 6 6 6 6 35 6 6 6 6 6 6 6 
6 6 6 6 6 6 6 6 6 6 35 6 6 6 6 6 35 6 6 6 35 6 6 6 6 6 6 6 6 6 6 6 6 6 6 6 6 35 6 6 6 6 6 6 6 6 6 6 6 6 
6 6 6 6 6 6 35 6 6 6 6 6 6 6 6 6 6 6 6 6 6 6 6 6 6 6 6 6 6 6 6 6 6 6 6 6 6 6 6 6 6 6 6 6 6 6 6 6 6 6 
6 6 6 6 6 6 6 6 6 6 35 6 6 6 6 6 6 6 6 6 35 6 6 6 6 6 6 6 6 6 6 6 6 6 6 6 6 6 6 6 6 6 6 6 6 6 6 6 6 6 
6 6 6 6 6 6 6 6 6 6 6 6 6 6 6 6 6 6 6 6 6 6 6 6 6 6 6 6 6 6 6 6 6 6 6 6 6 6 6 6 6 6 6 6 6 6 6 6 6 6 
6 6 6 6 6 6 6 6 6 6 6 6 35 6 6 6 35 6 6 6 6 6 6 6 6 35 6 6 6 35 6 6 6 6 6 6 6 6 6 6 6 35 6 6 6 6 6 6 6 6 
6 6 6 6 6 6 6 6 6 6 6 6 6 6 6 6 6 6 6 6 6 6 6 6 6 6 6 6 6 6 6 6 6 6 6 6 6 6 6 6 6 6 6 6 6 6 6 6 6 6 
6 6 6 6 6 35 6 6 6 35 6 35 6 6 6 6 6 6 6 6 6 6 6 35 6 35 6 6 6 35 6 6 6 6 6 6 6 35 6 6 6 6 6 6 6 6 6 6 6 6 
6 6 6 6 6 6 6 6 6 6 6 6 6 6 6 6 6 35 6 6 6 6 6 6 6 6 6 6 6 6 6 6 6 6 6 6 6 6 6 6 6 6 6 6 6 6 6 6 6 6 
6 6 6 6 6 6 6 6 6 6 6 6 6 6 6 6 6 6 6 6 6 6 6 35 6 6 6 6 6 6 6 6 6 35 6 6 6 6 6 6 6 6 6 6 6 6 6 6 6 6 
6 6 6 6 6 6 6 6 6 6 6 35 6 6 6 6 6 6 6 6 6 6 6 6 6 6 6 6 6 6 6 6 35 6 6 6 6 6 6 6 6 6 6 6 6 6 6 6 6 6 
6 6 6 6 6 6 6 6 6 6 6 6 6 6 6 6 6 35 6 6 6 6 6 35 35 6 6 6 6 6 6 6 6 6 6 6 6 6 6 6 6 6 6 6 6 6 6 6 6 6 
6 6 6 6 6 6 6 6 6 6 6 6 6 6 6 6 6 6 6 6 6 6 6 6 6 6 6 6 6 6 6 6 35 6 6 6 6 6 6 6 6 6 6 6 6 6 6 6 6 6 
6 6 6 6 6 6 6 6 6 6 6 6 6 6 6 6 6 6 6 6 6 6 6 6 6 6 6 6 6 35 6 6 6 6 6 6 6 6 6 6 6 6 6 6 6 6 6 6 6 6 
6 6 6 6 6 6 6 6 6 6 6 6 6 6 6 6 6 6 6 6 6 6 6 6 6 6 6 6 6 6 6 6 6 6 6 6 6 6 6 6 6 6 6 6 6 6 6 6 6 6 
6 6 6 6 6 6 6 6 6 6 6 6 6 6 6 6 6 6 6 6 6 6 6 6 6 6 6 6 6 6 6 6 6 6 6 6 6 6 6 6 6 6 6 6 6 6 6 6 6 6 
6 6 6 6 6 6 6 6 6 6 6 6 6 6 6 6 6 6 6 6 6 6 6 6 6 6 35 6 6 6 6 6 6 6 6 6 6 6 6 6 6 35 6 6 6 6 6 6 6 6 
6 6 6 6 6 6 6 6 6 6 6 6 6 6 6 6 6 6 6 6 6 6 6 6 6 6 6 6 6 6 6 6 6 6 6 6 35 6 6 6 6 6 6 6 6 6 6 6 6 6 
6 6 6 6 6 6 6 6 6 6 6 6 6 6 6 6 6 6 6 6 6 6 6 6 6 6 6 6 6 6 6 6 6 6 6 6 6 6 6 6 6 6 6 6 6 6 6 6 6 6 
6 6 6 6 6 6 6 6 6 6 6 6 6 6 6 6 6 6 6 6 6 6 6 6 6 6 6 6 6 6 6 6 6 6 6 6 6 6 6 6 6 6 6 6 6 6 6 6 6 6 
6 6 6 6 6 6 6 6 6 6 6 6 6 6 6 6 6 6 6 6 6 6 6 6 6 6 6 6 6 6 6 6 6 6 6 6 6 6 6 6 6 6 6 6 6 6 6 6 6 6 
6 6 6 6 6 6 6 6 6 6 6 6 6 6 6 6 6 6 6 6 6 6 6 6 6 6 6 6 6 6 6 6 6 6 6 6 6 6 6 6 6 6 6 6 6 6 6 6 6 6 
6 6 6 6 6 6 6 6 6 6 6 6 6 6 6 6 6 6 6 6 6 6 6 6 6 6 6 6 6 6 6 6 6 6 6 6 6 6 6 6 6 6 6 6 6 6 6 6 6 6 
6 6 6 6 6 6 6 6 6 6 6 6 6 6 6 6 6 6 6 6 6 6 6 6 6 6 6 6 6 6 6 6 6 6 6 6 6 6 6 6 6 6 6 6 6 6 6 6 6 6 
6 6 6 6 6 6 6 6 6 6 6 6 6 6 6 6 6 6 6 6 6 6 6 6 6 6 6 6 6 6 6 6 6 6 6 6 6 6 6 6 6 6 6 6 6 6 6 6 6 6 
6 6 6 6 6 6 6 6 6 6 6 6 6 6 6 6 6 6 6 6 6 6 6 6 6 6 6 6 6 6 6 6 6 6 6 6 6 6 6 6 6 6 6 6 6 6 6 6 6 6 
6 6 6 6 6 6 6 6 6 6 6 6 6 6 6 6 6 6 6 6 6 6 6 6 6 6 6 6 6 6 6 6 6 6 6 6 6 6 6 6 6 6 6 6 6 6 6 6 6 6 
