1 1 1 1 1 1 1 1 1 1 1 1 1 1 1 1 1 1 1 32 34 34 34 34 32 1 1 1 1 1 1 1 1 1 16 16 16 16 1 1 1 1 1 1 1 1 1 1 1 1 
1 16 16 16 16 1 1 1 1 1 1 16 16 16 1 1 1 16 1 32 179 179 179 179 32 1 1 1 16 1 1 1 1 1 16 1 1 1 1 16 1 1 1 1 1 1 1 1 1 16 
1 1 1 1 1 1 1 1 1 1 1 1 1 1 1 1 1 16 1 32 34 34 34 34 32 1 1 1 16 16 1 1 1 1 16 1 1 1 1 16 1 1 16 16 16 16 1 1 16 16 
1 1 1 1 1 16 16 16 16 1 1 1 1 1 16 16 1 16 1 32 34 34 34 34 32 1 1 1 1 16 16 16 1 1 16 1 1 1 16 16 1 1 1 1 1 1 1 1 16 1 
1 1 1 1 1 16 1 1 1 1 1 1 16 16 1 1 1 1 1 32 34 34 34 34 32 1 1 1 1 1 1 16 16 1 16 16 1 1 1 16 16 1 1 1 1 1 1 1 1 1 
1 1 1 16 16 1 1 1 1 1 1 1 1 1 1 1 1 20 21 32 34 34 34 34 32 22 1 1 1 1 1 1 1 1 1 16 1 1 1 1 1 1 16 1 16 1 1 1 16 1 
1 1 1 1 1 1 1 1 1 1 16 1 1 1 1 1 20 31 200 32 34 34 34 34 32 30 21 21 22 1 1 1 1 1 1 1 16 1 1 1 1 1 16 1 16 1 1 1 16 1 
1 1 1 1 1 1 1 16 16 16 1 1 1 1 1 20 31 200 200 200 200 200 200 200 200 200 200 200 30 22 1 1 1 1 1 1 16 16 1 1 1 1 16 1 1 1 1 1 16 1 
1 1 16 16 1 1 16 1 1 1 1 16 16 1 20 31 200 200 200 200 200 200 200 200 200 200 200 200 200 200 22 1 1 1 1 1 1 1 1 16 16 1 1 16 1 1 1 1 16 16 
1 1 1 1 1 1 1 1 1 16 16 1 1 20 31 200 200 200 200 200 200 200 200 200 200 200 200 200 200 200 30 21 22 1 1 1 1 1 1 1 1 1 1 16 1 1 1 1 1 1 
1 1 1 1 1 1 1 1 1 1 1 20 21 31 200 200 200 200 200 200 200 200 200 200 200 200 200 200 200 200 200 200 30 22 1 1 1 1 1 1 1 1 1 16 1 1 1 1 1 1 
1 1 16 16 16 16 1 1 1 1 1 23 200 200 200 200 200 200 200 200 200 200 200 200 200 200 200 200 200 200 200 200 200 30 22 1 1 1 16 1 1 1 1 16 1 1 16 1 1 1 
1 1 1 1 1 1 1 1 1 1 20 31 200 200 200 200 200 200 200 200 200 200 200 200 200 200 200 200 200 200 200 200 200 200 30 22 1 1 1 16 1 1 1 16 1 1 16 1 1 1 
1 1 1 1 1 16 1 1 1 20 31 200 200 200 200 200 200 200 200 200 200 200 200 200 200 200 200 200 200 200 200 200 200 200 200 30 22 1 1 1 1 1 1 1 1 1 1 1 1 1 
22 1 1 1 1 1 1 20 21 31 200 200 200 200 200 200 200 200 200 200 200 200 200 200 200 200 200 200 200 200 200 200 200 200 200 200 30 22 1 1 1 1 1 1 16 1 1 1 16 1 
30 22 1 1 1 20 21 31 18 18 18 18 18 18 18 18 18 18 18 18 18 18 18 18 18 18 18 18 18 18 18 18 18 18 18 18 18 30 21 22 1 1 1 16 16 1 1 1 1 16 
18 30 21 21 21 31 18 18 18 18 18 18 18 18 18 18 18 18 18 18 18 18 18 18 18 18 18 18 18 18 18 18 18 18 18 18 18 18 18 24 1 1 1 16 1 1 1 1 1 16 
18 18 18 18 18 18 18 18 18 18 18 18 18 18 18 18 18 18 18 18 18 18 18 18 18 18 18 18 18 18 18 18 18 18 18 18 18 18 18 30 22 1 1 1 1 1 16 1 1 16 
18 18 18 18 18 18 18 18 18 18 18 18 18 18 18 18 18 18 18 18 18 18 18 18 18 18 18 18 18 18 18 18 18 18 18 18 18 18 18 18 24 1 1 1 1 1 1 1 1 1 
18 18 18 18 18 18 18 18 18 18 18 18 18 18 18 18 18 18 18 18 18 18 18 18 18 18 18 18 18 18 18 18 18 18 18 18 18 18 18 18 30 22 1 1 1 1 16 1 1 1 
18 18 18 18 18 18 18 18 18 18 18 18 18 18 18 18 18 18 18 18 18 18 18 18 18 18 18 18 18 18 18 18 18 18 18 18 18 18 18 18 18 24 1 1 1 1 16 1 1 1 
18 18 18 18 18 18 18 18 18 18 18 18 18 18 18 18 18 18 18 18 28 26 26 26 26 26 26 26 29 18 18 18 18 18 18 18 18 18 18 18 18 24 1 1 1 16 1 16 1 1 
18 18 18 18 18 18 18 18 18 18 18 18 18 18 18 18 18 18 28 26 27 1 1 1 1 1 1 1 25 29 18 18 18 18 18 18 18 18 18 18 18 24 1 1 16 1 1 1 16 1 
18 18 18 18 18 18 18 18 18 18 18 18 18 18 18 28 26 26 27 1 1 1 1 1 16 1 1 1 1 23 18 18 18 18 18 18 18 18 18 18 18 24 1 1 16 1 1 1 1 1 
18 18 18 18 18 18 18 18 18 18 18 18 18 18 18 24 1 1 1 1 1 16 16 1 1 1 1 1 1 23 18 18 18 18 18 18 18 18 18 18 18 24 1 1 16 1 1 1 1 1 
18 18 18 18 18 18 18 18 18 18 18 18 18 28 26 27 1 1 1 16 16 1 1 1 1 1 1 1 1 23 18 18 18 18 18 18 18 18 18 18 28 27 1 1 1 1 1 1 1 1 
18 18 18 18 18 18 18 18 18 18 18 28 26 27 1 1 1 1 16 16 1 1 1 1 1 1 1 1 1 23 18 18 18 18 18 18 18 18 18 18 24 1 1 1 1 1 1 16 1 1 
18 18 18 18 18 18 18 18 18 18 18 27 1 1 1 1 1 1 16 1 1 1 1 1 1 1 1 1 1 23 18 18 18 18 18 18 18 18 18 28 27 1 1 1 1 1 16 1 1 1 
18 18 18 18 18 18 18 18 28 26 27 1 1 1 1 1 1 1 1 1 1 1 1 1 1 1 1 1 20 31 18 18 18 18 18 18 18 18 28 27 1 1 16 1 1 1 16 1 1 1 
18 18 18 18 28 26 26 26 27 1 1 1 1 1 1 1 1 1 1 1 1 1 1 1 1 1 1 1 23 18 18 18 18 18 18 18 18 18 24 1 1 1 16 1 1 1 16 1 1 1 
26 26 26 26 27 1 1 1 1 1 1 1 1 1 16 16 16 16 1 1 1 1 16 1 1 1 1 1 23 18 18 18 18 18 18 18 28 26 27 1 1 16 1 1 1 16 16 1 1 1 
1 1 1 1 1 1 1 1 1 16 16 1 1 1 16 1 1 1 1 1 1 1 16 1 1 1 1 20 31 18 18 18 18 18 18 18 24 1 1 1 1 16 1 1 1 16 1 1 16 1 
1 1 1 1 1 1 16 1 16 1 1 1 1 1 1 1 1 1 1 1 1 16 1 1 1 1 20 31 18 18 18 18 18 18 18 18 24 1 1 1 1 1 1 16 1 1 1 1 1 1 
1 1 1 1 16 16 1 1 1 1 1 1 1 1 1 1 1 1 1 1 1 16 1 1 1 1 23 18 18 18 18 18 18 18 18 18 24 1 1 1 1 1 16 1 1 1 1 1 1 1 
1 1 1 1 1 1 1 1 1 1 1 1 1 1 1 1 1 16 1 1 1 16 1 1 1 1 23 18 18 18 18 18 18 18 18 18 24 1 1 1 1 1 16 16 16 16 1 1 1 1 
1 1 1 1 1 1 1 1 1 1 1 1 1 1 1 1 16 16 1 1 1 1 1 1 1 1 25 29 18 18 18 18 18 18 18 18 30 21 21 22 1 1 1 1 1 1 1 1 1 20 
1 1 1 1 1 1 1 1 1 1 16 1 1 1 1 1 1 1 1 1 1 1 1 1 1 1 1 23 18 18 18 18 18 18 18 18 18 18 18 24 1 1 1 1 1 1 1 1 20 31 
1 1 1 1 1 1 1 1 1 1 16 1 1 1 1 1 1 1 1 1 1 1 1 1 1 1 1 25 29 18 18 18 18 18 18 18 18 18 18 30 21 22 1 1 1 1 1 20 31 18 
1 1 1 1 1 1 1 1 1 1 16 1 1 1 1 1 1 1 16 1 1 1 1 16 1 1 1 1 23 18 18 18 18 18 18 18 18 18 18 18 18 30 21 21 21 21 21 31 18 18 
1 1 1 1 1 1 1 1 1 1 1 1 1 1 1 1 1 1 16 1 1 1 1 16 1 1 1 1 25 29 18 18 18 18 18 18 18 18 18 18 18 18 18 18 18 18 18 18 18 18 
1 1 1 1 1 1 1 1 1 1 1 1 1 1 1 1 1 16 1 1 1 1 1 1 16 1 1 1 1 25 29 18 18 18 18 18 18 18 18 18 18 18 18 18 18 18 18 18 18 18 
1 1 1 1 1 1 1 1 1 1 1 1 1 1 1 1 16 16 1 1 1 1 16 1 1 16 1 1 1 1 25 26 29 18 18 18 18 18 18 18 18 18 18 18 18 18 18 18 18 18 
1 1 1 1 1 1 1 1 16 16 1 1 1 1 1 16 1 1 1 1 1 1 16 1 1 16 1 1 1 1 1 1 25 29 18 18 18 18 18 18 18 18 18 18 18 18 18 18 18 18 
1 1 1 1 1 1 1 16 1 1 1 1 1 1 1 1 1 1 1 1 1 1 16 1 1 1 16 1 1 1 1 1 1 25 29 18 18 18 18 18 18 18 18 18 18 18 18 18 18 18 
1 1 1 1 1 1 1 16 1 1 1 1 1 1 1 1 1 1 1 1 1 1 16 1 1 1 1 1 1 1 1 1 16 1 25 29 18 18 18 18 18 18 18 18 18 18 18 18 18 18 
1 1 1 1 1 1 1 16 1 1 1 1 1 1 1 1 1 1 1 1 1 1 16 1 1 1 1 1 16 16 1 1 16 16 1 23 18 18 18 18 18 18 18 18 1 1 1 1 1 1 
1 1 1 1 1 1 1 1 1 1 1 1 1 1 16 16 1 1 1 1 1 16 16 1 1 1 1 1 1 16 16 1 1 16 1 1 1 1 1 1 1 1 1 1 1 1 16 16 1 1 
1 1 1 1 1 1 1 1 1 1 1 1 1 16 16 1 1 1 1 1 1 1 1 1 1 1 1 1 1 1 1 16 16 16 16 1 1 1 1 1 16 1 1 1 1 1 1 16 1 1 
1 1 1 1 1 1 1 1 1 1 1 1 16 16 1 1 1 1 1 1 1 1 1 1 1 1 1 1 1 1 1 1 1 1 1 1 1 1 1 1 1 16 16 16 16 1 1 1 1 1 
1 1 1 1 1 1 1 1 1 1 1 1 16 1 1 1 1 1 1 1 1 1 1 1 1 1 1 1 1 1 1 1 1 1 1 1 16 16 1 1 1 1 1 1 1 16 1 1 1 1 
