1 1 1 1 1 1 1 1 1 1 1 1 1 1 1 1 1 1 1 32 34 34 34 34 32 1 1 1 1 1 1 1 1 1 16 16 16 16 1 1 1 1 1 1 1 1 1 1 1 1 
1 16 16 16 16 1 1 1 1 1 1 16 16 16 1 1 1 16 1 32 34 34 34 34 32 1 1 1 16 1 1 1 1 1 16 1 1 1 1 16 1 1 1 1 1 1 1 1 1 16 
1 1 1 1 1 1 1 1 1 1 1 1 1 1 1 1 1 16 1 32 34 34 34 34 32 1 1 1 16 16 1 1 1 1 16 1 1 1 1 16 1 1 16 16 16 16 1 1 16 16 
1 1 1 1 1 16 16 16 16 1 1 1 1 1 16 16 1 16 1 32 34 34 34 34 32 1 1 1 1 16 16 16 1 1 16 1 1 1 16 16 1 1 1 1 1 1 1 1 16 1 
1 1 1 1 1 16 1 1 1 1 1 1 16 16 1 1 1 1 1 32 34 34 34 34 32 1 1 1 1 1 1 16 16 1 16 16 1 1 1 16 16 1 1 1 1 1 1 1 1 1 
1 1 1 16 16 1 1 1 1 1 1 1 1 1 1 1 1 18 18 32 34 34 34 34 32 18 1 1 1 1 1 1 1 1 1 16 1 1 1 1 1 1 16 1 16 1 1 1 16 1 
1 1 1 1 1 1 1 1 1 1 16 1 1 1 1 1 18 18 18 32 34 34 34 34 32 18 18 18 18 1 1 1 1 1 1 1 16 1 1 1 1 1 16 1 16 1 1 1 16 1 
1 1 1 1 1 1 1 16 16 16 1 1 1 1 1 18 18 18 18 18 18 18 18 18 18 18 18 18 18 18 1 1 1 1 1 1 16 16 1 1 1 1 16 1 1 1 1 1 16 1 
1 1 16 16 1 1 16 1 1 1 1 16 16 1 18 18 18 18 18 18 18 18 18 18 18 18 18 18 18 18 18 1 1 1 1 1 1 1 1 16 16 1 1 16 1 1 1 1 16 16 
1 1 1 1 1 1 1 1 1 16 16 1 1 18 18 18 18 18 18 18 18 18 18 18 18 18 18 18 18 18 18 18 18 1 1 1 1 1 1 1 1 1 1 16 1 1 1 1 1 1 
1 1 1 1 1 1 1 1 1 1 1 18 18 18 18 18 18 18 18 18 18 18 18 18 18 18 18 18 18 18 18 18 18 18 1 1 1 1 1 1 1 1 1 16 1 1 1 1 1 1 
1 1 16 16 16 16 1 1 1 1 1 18 18 18 18 18 18 18 18 18 18 18 18 18 18 18 18 18 18 18 18 18 18 18 18 1 1 1 16 1 1 1 1 16 1 1 16 1 1 1 
1 1 1 1 1 1 1 1 1 1 18 18 18 18 18 18 18 18 18 18 18 18 18 18 18 18 18 18 18 18 18 18 18 18 18 18 1 1 1 16 1 1 1 16 1 1 16 1 1 1 
1 1 1 1 1 16 1 1 1 18 18 18 18 18 18 18 18 18 18 18 18 18 18 18 18 18 18 18 18 18 18 18 18 18 18 18 18 1 1 1 1 1 1 1 1 1 1 1 1 1 
18 1 1 1 1 1 1 18 18 18 18 18 18 18 18 18 18 18 18 18 18 18 18 18 18 18 18 18 18 18 18 18 18 18 18 18 18 18 1 1 1 1 1 1 16 1 1 1 16 1 
18 18 1 1 1 18 18 18 18 18 18 18 18 18 18 18 18 18 18 18 18 18 18 18 18 18 18 18 18 18 18 18 18 18 18 18 18 18 18 18 1 1 1 16 16 1 1 1 1 16 
18 18 18 18 18 18 18 18 18 18 18 18 18 18 18 18 18 18 18 18 18 18 18 18 18 18 18 18 18 18 18 18 18 18 18 18 18 18 18 18 1 1 1 16 1 1 1 1 1 16 
18 18 18 18 18 18 18 18 18 18 18 18 18 18 18 18 18 18 18 18 18 18 18 18 18 18 18 18 18 18 18 18 18 18 18 18 18 18 18 18 18 1 1 1 1 1 16 1 1 16 
18 18 18 18 18 18 18 18 18 18 18 18 18 18 18 18 18 18 18 18 18 18 18 18 18 18 18 18 18 18 18 18 18 18 18 18 18 18 18 18 18 1 1 1 1 1 1 1 1 1 
18 18 18 18 18 18 18 18 18 18 18 18 18 18 18 18 18 18 18 18 18 18 18 18 18 18 18 18 18 18 18 18 18 18 18 18 18 18 18 18 18 18 1 1 1 1 16 1 1 1 
18 18 18 18 18 18 18 18 18 18 18 18 18 18 18 18 18 18 18 18 18 18 18 18 18 18 18 18 18 18 18 18 18 18 18 18 18 18 18 18 18 18 1 1 1 1 16 1 1 1 
18 18 18 18 18 18 18 18 18 18 18 18 18 18 18 18 18 18 18 18 18 18 18 18 18 18 18 18 18 18 18 18 18 18 18 18 18 18 18 18 18 18 1 1 1 16 1 16 1 1 
18 18 18 18 18 18 18 18 18 18 18 18 18 18 18 18 18 18 18 18 18 1 1 1 1 1 1 1 18 18 18 18 18 18 18 18 18 18 18 18 18 18 1 1 16 1 1 1 16 1 
18 18 18 18 18 18 18 18 18 18 18 18 18 18 18 18 18 18 18 1 1 1 1 1 16 1 1 1 1 18 18 18 18 18 18 18 18 18 18 18 18 18 1 1 16 1 1 1 1 1 
18 18 18 18 18 18 18 18 18 18 18 18 18 18 18 18 1 18 1 1 1 16 16 1 1 1 1 1 1 18 18 18 18 18 18 18 18 18 18 18 18 18 1 1 16 1 1 1 1 1 
18 18 18 18 18 18 18 18 18 18 18 18 18 18 18 18 1 1 1 16 16 1 1 1 1 1 1 1 1 18 18 18 18 18 18 18 18 18 18 18 18 18 1 1 1 1 1 1 1 1 
18 18 18 18 18 18 18 18 18 18 18 18 18 18 1 1 1 1 16 16 1 1 1 1 1 1 1 1 1 18 18 18 18 18 18 18 18 18 18 18 18 1 1 1 1 1 1 16 1 1 
18 18 18 18 18 18 18 18 18 18 18 18 1 1 1 1 1 1 16 1 1 1 1 1 1 1 1 1 1 18 18 18 18 18 18 18 18 18 18 18 18 1 1 1 1 1 16 1 1 1 
18 18 18 18 18 18 18 18 18 18 18 1 1 1 1 1 1 1 1 1 1 1 1 1 1 1 1 1 18 18 18 18 18 18 18 18 18 18 18 18 1 1 16 1 1 1 16 1 1 1 
18 18 18 18 18 18 18 18 18 1 1 1 1 1 1 1 1 1 1 1 1 1 1 1 1 1 1 1 18 18 18 18 18 18 18 18 18 18 18 1 1 1 16 1 1 1 16 1 1 1 
18 18 18 18 18 1 1 1 1 1 1 1 1 1 16 16 16 16 1 1 1 1 16 1 1 1 18 1 18 18 18 18 18 18 18 18 18 18 18 1 1 16 1 1 1 16 16 1 1 1 
1 1 1 1 1 1 1 1 1 16 16 1 1 1 16 1 1 1 1 1 1 1 16 1 1 1 1 18 18 18 18 18 18 18 18 18 18 1 1 1 1 16 1 1 1 16 1 1 16 1 
1 1 1 1 1 1 16 1 16 1 1 1 1 1 1 1 1 1 1 1 1 16 1 1 1 1 18 18 18 18 18 18 18 18 18 18 18 1 1 1 1 1 1 16 1 1 1 1 1 1 
1 1 1 1 16 16 1 1 1 1 1 1 1 1 1 1 1 1 1 1 1 16 1 1 1 1 18 18 18 18 18 18 18 18 18 18 18 1 1 1 1 1 16 1 1 1 1 1 1 1 
1 1 1 1 1 1 1 1 1 1 1 1 1 1 1 1 1 16 1 1 1 16 1 1 1 1 18 18 18 18 18 18 18 18 18 18 18 1 1 1 1 1 16 16 16 16 1 1 1 1 
1 1 1 1 1 1 1 1 1 1 1 1 1 1 1 1 16 16 1 1 1 1 1 1 1 1 18 18 18 18 18 18 18 18 18 18 18 18 18 18 1 1 1 1 1 1 1 1 1 18 
1 1 1 1 1 1 1 1 1 1 16 1 1 1 1 1 1 1 1 1 1 1 1 1 1 1 1 18 18 18 18 18 18 18 18 18 18 18 18 18 1 1 1 1 1 1 1 1 18 18 
1 1 1 1 1 1 1 1 1 1 16 1 1 1 1 1 1 1 1 1 1 1 1 1 1 1 1 18 18 18 18 18 18 18 18 18 18 18 18 18 18 18 1 1 1 1 1 18 18 18 
1 1 1 1 1 1 1 1 1 1 16 1 1 1 1 1 1 1 16 1 1 1 1 16 1 1 1 1 18 18 18 18 18 18 18 18 18 18 18 18 18 18 18 18 18 18 18 18 18 18 
1 1 1 1 1 1 1 1 1 1 1 1 1 1 1 1 1 1 16 1 1 1 1 16 1 1 1 1 18 18 18 18 18 18 18 18 18 18 18 18 18 18 18 18 18 18 18 18 18 18 
1 1 1 1 1 1 1 1 1 1 1 1 1 1 1 1 1 16 1 1 1 1 1 1 16 1 1 1 1 18 18 18 18 18 18 18 18 18 18 18 18 18 18 18 18 18 18 18 18 18 
1 1 1 1 1 1 1 1 1 1 1 1 1 1 1 1 16 16 1 1 1 1 16 1 1 16 1 1 1 1 18 18 18 18 18 18 18 18 18 18 18 18 18 18 18 18 18 18 18 18 
1 1 1 1 1 1 1 1 16 16 1 1 1 1 1 16 1 1 1 1 1 1 16 1 1 16 1 1 1 1 1 1 18 18 18 18 18 18 18 18 18 18 18 18 18 18 18 18 18 18 
1 1 1 1 1 1 1 16 1 1 1 1 1 1 1 1 1 1 1 1 1 1 16 1 1 1 16 1 1 1 1 1 1 18 18 18 18 18 18 18 18 18 18 18 18 18 18 18 18 18 
1 1 1 1 1 1 1 16 1 1 1 1 1 1 1 1 1 1 1 1 1 1 16 1 1 1 1 1 1 1 1 1 16 1 18 18 18 18 18 18 18 18 18 18 18 18 18 18 18 18 
1 1 1 1 1 1 1 16 1 1 1 1 1 1 1 1 1 1 1 1 1 1 16 1 1 1 1 1 16 16 1 1 16 16 1 18 18 18 18 18 18 18 18 18 1 1 1 1 1 1 
1 1 1 1 1 1 1 1 1 1 1 1 1 1 16 16 1 1 1 1 1 16 16 1 1 1 1 1 1 16 16 1 1 16 1 1 1 1 1 1 1 1 1 1 1 1 16 16 1 1 
1 1 1 1 1 1 1 1 1 1 1 1 1 16 16 1 1 1 1 1 1 1 1 1 1 1 1 1 1 1 1 16 16 16 16 1 1 1 1 1 16 1 1 1 1 1 1 16 1 1 
1 1 1 1 1 1 1 1 1 1 1 1 16 16 1 1 1 1 1 1 1 1 1 1 1 1 1 1 1 1 1 1 1 1 1 1 1 1 1 1 1 16 16 16 16 1 1 1 1 1 
1 1 1 1 1 1 1 1 1 1 1 1 16 1 1 1 1 1 1 1 1 1 1 1 1 1 1 1 1 1 1 1 1 1 1 1 16 16 1 1 1 1 1 1 1 16 1 1 1 1 
