18 18 18 18 18 18 18 18 18 18 18 18 18 18 18 18 18 18 18 18 18 18 18 18 18 18 18 18 18 18 18 18 18 18 18 18 18 18 18 18 18 18 18 18 18 18 18 18 18 18 
18 18 18 18 18 18 18 18 18 18 18 18 18 18 18 18 18 18 18 18 18 18 18 18 18 18 18 18 18 18 18 18 18 18 18 18 18 18 18 18 18 18 18 18 18 18 18 18 18 18 
18 18 18 18 18 18 18 18 18 18 18 18 18 18 18 18 18 18 18 18 18 18 18 18 18 18 18 18 18 18 18 18 18 18 18 18 18 18 18 18 18 18 18 18 18 18 18 18 18 18 
18 18 18 18 18 18 18 18 18 18 18 18 18 18 18 18 18 18 18 18 18 18 18 18 18 18 18 18 18 18 18 18 18 18 18 18 18 18 18 18 18 18 18 18 18 18 18 18 18 18 
18 18 18 18 28 26 26 26 26 26 26 26 26 26 26 26 26 26 26 26 26 26 26 26 26 26 26 26 26 26 26 26 29 18 18 18 18 18 18 18 18 18 18 18 18 18 18 18 18 18 
18 18 18 18 24 1 1 1 1 1 1 1 1 1 1 1 1 1 1 1 1 1 1 1 1 1 1 1 1 1 1 1 23 18 18 18 18 18 18 18 18 18 18 18 18 18 18 18 18 18 
18 18 18 18 24 1 16 16 16 16 16 16 16 16 16 16 16 16 16 16 16 16 16 16 16 16 16 16 16 16 16 1 25 26 29 18 18 18 18 18 18 18 18 18 18 18 18 18 18 18 
18 18 18 18 24 1 16 1 12 10 13 1 1 1 1 1 1 1 1 1 1 1 1 1 1 1 1 1 1 1 1 16 2 16 23 18 18 18 18 18 18 18 18 18 18 18 18 18 18 18 
18 18 18 18 24 1 16 1 8 3 7 2 1 16 1 2 1 16 1 1 1 16 1 1 1 1 1 1 1 1 1 1 1 16 23 200 200 18 18 18 18 18 18 18 18 18 18 18 18 18 
18 18 18 18 24 1 16 1 8 3 7 1 1 1 1 1 1 1 1 1 1 1 12 10 10 10 10 10 10 10 10 10 10 48 25 26 203 26 29 18 18 18 18 18 18 18 18 18 18 18 
18 18 18 18 24 1 16 1 8 3 7 16 1 1 1 1 1 16 1 1 1 1 8 3 3 3 3 3 3 3 3 3 3 7 1 12 10 13 25 29 200 18 18 18 18 18 18 18 18 18 
18 18 18 18 24 1 16 1 8 3 7 1 1 16 1 1 1 1 1 1 16 1 8 3 3 3 3 4 5 5 5 6 3 9 10 11 3 7 1 25 26 29 18 18 18 18 18 18 18 18 
18 18 18 18 24 1 16 1 8 3 7 1 1 1 1 1 1 16 1 1 1 1 8 3 3 3 3 7 1 1 1 8 3 3 3 3 3 7 1 1 1 23 18 18 18 18 18 18 18 18 
18 18 18 18 24 1 16 1 8 3 7 16 1 1 1 1 1 1 1 1 16 16 8 3 3 3 3 7 1 1 1 14 5 5 5 5 5 15 1 1 16 25 26 29 18 18 18 18 18 18 
18 18 18 18 24 1 16 1 8 3 9 10 10 10 10 10 10 10 10 10 10 10 11 3 3 3 3 9 10 10 10 10 10 10 10 13 2 1 1 1 16 16 16 25 26 29 18 18 18 18 
18 18 18 18 24 1 16 1 8 3 3 3 3 3 3 3 3 3 3 3 3 3 3 3 3 3 3 3 3 3 3 3 3 3 3 7 1 16 1 1 1 1 16 16 1 23 18 18 18 18 
18 18 18 18 24 1 16 1 8 3 3 3 3 3 3 3 3 3 3 3 3 3 3 3 3 3 3 3 3 3 3 3 3 3 3 7 1 1 2 1 16 1 1 16 1 23 18 18 18 18 
18 18 18 18 24 1 16 1 14 5 5 5 5 5 6 3 3 4 5 5 5 5 6 3 3 3 3 4 5 5 5 5 6 3 3 7 1 1 1 1 16 1 1 16 1 23 18 18 18 18 
18 18 18 18 24 1 16 1 1 16 1 1 1 16 8 3 3 7 33 1 1 33 8 3 3 3 3 7 198 1 1 198 8 3 3 7 1 1 16 1 1 1 1 16 1 23 18 18 18 18 
18 18 18 18 24 1 16 1 1 1 16 1 1 1 8 3 3 7 1 1 2 1 8 3 3 3 3 7 1 1 1 2 8 3 3 7 1 1 1 1 1 16 1 16 1 23 18 18 18 18 
18 18 18 18 24 1 16 1 1 1 1 1 1 2 8 3 3 7 1 1 1 1 8 3 3 3 3 7 1 2 1 1 8 3 3 7 1 1 1 1 16 1 1 16 1 23 18 18 18 18 
18 18 18 18 24 1 16 1 1 16 1 2 1 1 8 3 3 7 1 2 1 1 8 3 3 3 3 1 1 1 1 1 8 3 3 7 1 16 1 1 1 1 1 16 1 23 18 18 18 18 
18 18 18 18 24 1 16 1 1 1 1 1 1 1 8 3 3 7 197 1 1 197 8 3 3 3 3 7 197 1 1 197 8 3 3 7 1 1 1 1 1 1 1 16 1 23 18 18 18 18 
18 18 18 18 24 1 16 1 1 1 1 1 16 1 8 3 3 7 1 1 1 1 8 3 3 3 3 7 1 1 1 1 8 3 3 7 16 1 16 1 1 16 1 16 1 23 18 18 18 18 
18 18 18 18 24 1 16 1 1 12 10 10 10 10 11 3 3 9 10 10 10 10 11 3 3 3 3 9 10 10 10 10 11 3 3 9 10 10 10 10 10 13 1 16 1 23 18 18 18 18 
18 18 18 18 24 1 16 1 1 8 3 3 3 3 3 3 3 3 3 3 3 3 3 3 35 35 3 3 3 3 3 3 3 3 3 3 3 3 3 3 3 7 1 16 1 23 18 18 18 18 
18 18 18 18 24 1 16 1 1 8 3 3 3 3 3 3 3 3 3 3 3 3 3 3 35 35 3 3 3 3 3 3 3 3 3 3 3 3 3 3 3 7 1 16 1 23 18 18 18 18 
18 18 18 18 24 1 16 1 1 8 3 3 4 5 6 3 3 4 5 5 5 5 6 3 3 3 3 4 5 5 5 5 6 3 3 4 5 5 5 5 5 15 1 16 1 23 18 18 18 18 
18 18 18 18 24 1 16 1 1 8 3 3 7 1 8 3 3 7 33 1 1 33 8 3 3 3 3 7 197 1 1 197 8 3 3 7 1 16 1 2 1 16 1 16 1 23 18 18 18 18 
32 32 32 32 32 10 10 10 10 11 3 3 7 1 8 3 3 7 1 1 1 1 8 3 3 3 3 7 1 1 1 1 8 3 3 7 1 1 1 1 1 1 16 16 1 23 18 18 18 18 
199 199 199 199 199 199 199 199 199 199 199 199 7 1 8 3 3 7 1 1 1 1 8 3 3 3 3 7 1 1 1 1 8 3 3 7 1 1 1 16 1 1 1 16 1 23 18 18 18 18 
32 32 32 32 32 5 5 5 5 5 5 5 50 1 8 3 3 7 1 1 1 1 8 3 3 3 3 7 1 1 1 1 8 3 3 7 1 1 1 16 1 2 1 16 1 23 18 18 18 18 
18 18 18 18 24 1 1 1 1 1 1 1 15 2 8 3 3 7 198 1 1 198 8 3 3 3 3 7 197 1 1 197 8 3 3 7 1 1 1 1 1 1 1 16 1 23 18 18 18 18 
18 18 18 18 24 1 16 1 1 1 1 1 1 1 8 3 3 9 10 10 10 10 11 3 3 3 3 9 10 10 10 10 11 3 3 7 1 16 1 1 16 1 1 16 1 23 18 18 18 18 
18 18 18 18 24 1 16 1 1 1 1 1 1 1 8 3 3 3 3 3 3 3 3 3 3 3 3 3 3 3 3 3 3 3 3 7 1 1 1 1 1 1 1 16 1 23 18 18 18 18 
18 18 18 18 24 1 16 1 1 1 1 16 16 1 8 3 3 3 3 3 3 3 3 3 3 3 3 3 3 3 3 3 3 3 3 7 1 16 1 1 1 16 1 16 1 23 18 18 18 18 
18 18 18 18 24 1 16 1 1 1 1 1 1 16 14 5 5 5 5 5 5 5 6 3 3 3 3 4 5 5 5 5 5 5 5 15 1 1 1 1 1 1 1 16 1 23 18 18 18 18 
18 18 18 18 24 1 16 1 1 16 1 1 1 1 1 1 1 1 1 1 1 1 8 3 3 3 3 7 1 1 1 1 1 1 1 1 1 1 1 1 2 1 1 16 1 23 18 18 18 18 
18 18 18 18 24 1 16 1 1 1 1 1 1 1 1 1 16 1 16 1 1 1 8 3 3 3 3 7 1 1 2 1 16 1 1 2 2 16 1 1 1 1 1 16 1 23 18 18 18 18 
18 18 18 18 24 1 16 1 1 1 2 1 1 1 16 1 1 1 1 1 16 1 8 3 3 3 3 7 1 1 1 1 1 1 1 1 1 1 1 1 16 1 1 16 1 23 18 18 18 18 
18 18 18 18 24 1 16 1 1 1 16 1 1 1 1 1 16 1 1 1 1 1 8 3 3 3 3 7 1 1 1 1 1 1 16 1 1 1 1 1 1 1 1 16 1 23 18 18 18 18 
18 18 18 18 24 1 16 1 1 1 1 1 1 1 1 1 1 1 1 1 1 1 8 3 3 3 3 7 2 1 1 16 1 1 1 2 1 16 1 1 1 16 1 16 1 23 18 18 18 18 
18 18 18 18 24 1 16 1 1 1 1 1 1 1 1 1 1 1 1 16 1 1 8 3 3 3 3 7 1 1 1 1 1 1 1 1 1 1 1 1 1 1 1 16 1 23 18 18 18 18 
18 18 18 18 24 1 16 16 16 16 16 16 16 16 16 16 16 16 16 16 16 16 8 3 3 3 3 7 16 16 16 16 16 16 16 16 16 16 16 16 16 16 16 16 1 23 18 18 18 18 
18 18 18 18 24 1 1 1 1 1 1 1 1 1 1 1 1 1 1 1 1 1 8 3 3 3 3 7 1 1 1 1 1 1 1 1 1 1 1 1 1 1 1 1 1 23 18 18 18 18 
18 18 18 18 30 21 21 21 21 21 21 21 21 21 21 21 21 21 21 21 21 21 21 32 3 3 32 21 21 21 21 21 21 21 21 21 21 21 21 21 21 21 21 21 21 31 18 18 18 18 
18 18 18 18 18 18 18 18 18 18 18 18 18 18 18 18 18 18 18 18 18 18 18 32 3 3 32 18 18 18 18 18 18 18 18 18 18 18 18 18 18 18 18 18 18 18 18 18 18 18 
18 18 18 18 18 18 18 18 18 18 18 18 18 18 18 18 18 18 18 18 18 18 18 32 3 3 32 18 18 18 18 18 18 18 18 18 18 18 18 18 18 18 18 18 18 18 18 18 18 18 
18 18 18 18 18 18 18 18 18 18 18 18 18 18 18 18 18 18 18 18 18 18 18 32 3 3 32 18 18 18 18 18 18 18 18 18 18 18 18 18 18 18 18 18 18 18 18 18 18 18 
18 18 18 18 18 18 18 18 18 18 18 18 18 18 18 18 18 18 18 18 18 18 18 32 3 3 32 18 18 18 18 18 18 18 18 18 18 18 18 18 18 18 18 18 18 18 18 18 18 18 
